R 640 480

NO ./textures/brick_texture.xpm
SO ./textures/mud_texture.xpm
WE ./textures/stone_texture.xpm
EA ./textures/white_texture.xpm
S  ./textures/barrel.xpm

F 100,100,100
C 135,205,235

1111111
1000S01
1000001
1002201
1000001
1111111