R 1024 768
NO ./textures/N.xpm
SO ./textures/S.xpm
WE ./textures/W.xpm
EA ./textures/E.xpm
S ./sprite/treasure.xpm
F 24,169,82
C 135,205,235

1111111111111111111111111111111111111
1000000000000000000000000000000000001
1000001000000000000000000000000000001
1001100000000000000000000000000000001
1000000000000000000000000000000000001
1000010000000000000000000000010000001
1000100000000000000000000100100000001
1001000000000000000000000000000000001
1000000000000000000010000000000000001
1000000000000000000000000000000001001
1000000000000000000000000000000000101
1000000000000000000000000000000000101
1001100000001000000000000000000000001
1000000000110000000000000000000000001
1000000000000000000000000000000000001
1010000000000000000000000000100000001
1000000000000000000000000100000000001
1000000000000000000000000000000000001
1000000000000000100000000000000000001
1000000000000000000100010000000001001
1010000000000000000000000001000000001
1000000000000000000000000000000000001
1000000000000000000000000000000000001
1000000000000000000000000000000000001
1001000000000000000000000000000000001
1000000000000000100000000000000000001
1000000000000000000000001000000000011
1000001000000000000001000000000000001
1000000000000000000000000000000000001
1001000000000000000000000000000000001
1000000000000100010001001000000000001
1000000000000100000000000000000000001
1000000000000010000000000000000000001
1000000000000000010000000000000000001
1000000000000000000000000010000000001
1000000000000000000000000000000000001
1111111111111111111111111111111111111
