R 1024 768
NO ./textures/N.xpm
SO ./textures/S.xpm
WE ./textures/W.xpm
EA ./textures/E.xpm
S ./sprite/treasure.xpm
F 63,255,50
C 135,205,235

1111111111111111111111111111111111111111111111111111
1100000000000000000000000001000100000000000000000001
1000000000000000000000000000000000000000000000000001
1000000000000000000000000000000000000000000000000001
1000000000000000000000000000000000000000000000000001
1000000000000000000000000010000000000000000000000001
1000000100000000000000000000000000000000000000000001
1000000000000000000000000000000000000000000000000001
1000000000000000000000000000000000100000000000000001
1000000000000000000000000000000000000000000000000001
1000000000000000000010000000000000000000000000000001
1000000000000000000000000000000000000000000000000001
1000000000000010000000000000000000000000000000000001
1000000000000000000000000000000000000000000000000001
1000000001000000000000000000000000000000000001000001
1000000000000000000000000000000000000000000000000001
1000000000000000000000000000000000000000000000000001
1000000000000000000000000000000000000000000000000001
1000000000000000000000000000000000000000000000000001
1000000000000000000000000000000000000000000000000001
1100000000000000000000000000000000000000000000000001
1000000000000000000000000001000000000000000010000001
1000000000000000000000000000000000010000000000000001
1000000000000010000000000000000000000000000000000001
1000000000000000000000000000000000000000000000000001
1000000000000000000000000000000000000000000000000001
1000000000000000000000000000000000000000000000000001
1000000000000000000000000000000000000000000000000001
1000000000000000000000000000000000000000000000000001
1000010000000000000000000000000000000000000000000101
1000000000000000000000000000000000000000000000000001
1000000001000000000000000000000000000000000000000001
1000000000000100000000000000000000000100010000000001
1000000000000000000000000000000000000000000000000001
1000000000000000000000000000000000000000000000000001
1000000000000000000000000000000000000000000000000001
1000000010000000000000000000000000000000000000000001
1000000000000000000000000000000000000000000000000001
1000000000000000000000000000000000000000000000000001
1000000000000000000000000000000000000000000000000001
1000000000000000000000000000000000000000000000000001
1000000000000000000000000000000000000000000000000001
1000000000000000000000000000000000000000000000000001
1000000000000000010000000000000000000000000000000001
1000000000000000000000100100000000000000000000000001
1000000000000000000000000000000000000000000000000001
1000000000000000000000000001000000000000000000000001
1000000000000000000000000000000000000000000000000101
1000000000000000000000000000000000001000000000000001
1000000000000000000000000000000000000000000000000001
1000000000000100000000000000000000000000000000000011
1111111111111111111111111111111111111111111111111111
