R      50 50

NO     ./textures/brick_texture.xpm
SO     ./textures/mud_texture.xpm
WE   ./textures/stone_texture.xpm
EA ./textures/white_texture.xpm
S  ./textures/barrel.xpm
F 100,100,100
C 135,205,235

111111111    
100  0001
100000001
1000S0021
100000001
100000001
111111111
