R 640 480
NO ./textures/N.xpm
SO ./textures/S.xpm
WE ./textures/W.xpm
EA ./textures/E.xpm
S ./sprite/treasure.xpm
F 100,255,100
C 135,205,235

1111111111111111111111111111111111111111111111111111
1000001000000000000000000000000000000000000000000001
1000001000000000000000000000000000000000000000000001
1000001000000000000000000000000000000000000000000001
1000001000000000000000000000000000000000000000000001
1000001000000000000000000000000000000000000000000001
1000001000000000000000000000000000000000000000000001
1000001000000000000111000000000000000000000000000001
1000000000000000000000000000000001000000000000000001
1000000000000000000000000000000001000000000000000001
1000000000000000000000000000000001000000000000000001
1000000000000000000000000000000001000000000000000001
1000000000011000000000000000000001000000000000000001
1000000000000000000000000000000001000000000000000001
1000000000000000000000000000000001000000000000000001
1000000000000000000000000000000001000000000000000001
1000000000000100000000000000000001000000000000000001
1000000000000000000000000000000000000000000000000001
1000000000000000000000000000000000000000000000000001
1000000000000000000000000000000000000000000000000001
1000000000000000000000000000000000000000000000000001
1000000000000000000000000001111110000000000000000001
1000000000000000000000000000000000000000000000000001
1000000000000000000000000000000000000000000000000001
1000000000000000000000000000000000000000000000000001
1000000000000000000000000000000000000000000000000001
1000000000000000000000000000000000000000000000000001
1000000000000000000000000000000000000000000000000001
10000000000000000000000S0000000000000000000000000001
1000000000000000000000000000000000000000000000000001
1000000000000000000000000000000000000000000000000001
1000000000000000000000000000000000000000000000000001
1000000000000000000000000000000000000000000000000001
1000000000000000000000000000000000000000000000000001
1000000000000000000000000000000000000000000000000001
1000000000000000000000000000000000000000000000000001
1000000000000000000000000000000000000000000000000001
1000000000000000000000000000000000000000000000000001
1000000000000000000000000000000000000000000000000001
1000000000000000000000000000000000000000000000000001
1000000000000000000000000000000000000000000000000001
1000000000000000000000000000000000000000000000000001
1000000000000000000000000000000000000000000000000001
1000000000000000000000000000000000000000000000000001
1000000000000000000000000000000000000000000000000001
1000000000000000000000000000000000000000000000000001
1000000000000000000000000000000000000000000000000001
1000000000000000000000000000000000000000000000000001
1000000000000000000000000000000000000000000000000001
1000000000000000000000000000000000000000000000000001
1000000000000000000000000000000000000000000000000001
1111111111111111111111111111111111111111111111111111
