R 1280 720
NO ./textures/N.xpm
SO ./textures/S.xpm
WE ./textures/W.xpm
EA ./textures/E.xpm
S ./sprite/treasure.xpm
F 0,150,50
C 135,205,235

111111111111111111111111111111111111111111
100000000000000000001001010010001000000001
100000000000100100000000000000000000000001
101000000000000000000000000000111000000001
101000001001101010000000100000000010000101
100000000001000000010010000000000000000001
100000000000000000001000000000000100000001
100001000000000000000010000000000000000001
100000000001000000000001000000000000000111
100001010000000001000100000001000000001001
100000000001000000000010000000010000000001
101000000000100000W00001000000000000010001
100010000000000000000000000000000000110001
100000001000000000000001000000000000101001
100000000000000001000100101000000000000001
100010000000100000100001000000000000100001
100100000010000000000000000000001000001001
110000000000000000100000000000000010000011
100000000000000000000001000000000000000011
100100000000000000000000000000000000000001
100000000000000000010000000000000000000101
100001000000001000100000001000001000100001
100110000000000100000010000001000000100001
100000000001000001000000000000000100000001
100000000000000000000000000000000001000001
101001000100110000010010110100001000000001
101000000000000000000000000001000000010001
100000000010010000000010000000010000000001
100000001000011001000000000000001000000001
100000000000000000000100000000000000000001
100000100000000110000000000000000000000001
100010000000000000000000000000001000000001
111000000011001000000000100010000000000001
100000000000000000000000000000000000000001
100000000000100000000000000000000000000101
100000001000000000000000100100000000000001
100100000000000000100001001000001000000001
100000000000000000000000000000000100000001
100010000000000110000000001000000100000001
100000000000000001000000100000000000000001
100000000000000010000001000000000000010001
111111111111111111111111111111111111111111
